1111111111111111111111111111111111
10000000000000P000C00E000000000001
1111111111111111111111111111111111